[volume]
Name=Volume
Description=Icons related to audio input and output volume

audio-volume-high=The icon used to indicate high audio volume
audio-volume-low=The icon used to indicate low audio volume
audio-volume-medium=The icon used to indicate medium audio volume
audio-volume-muted=The icon used to indicate the muted state for audio playback
microphone-sensitivity-high=The icon used to indicate high microphone sensitivity
microphone-sensitivity-low=The icon used to indicate low microphone sensitivity
microphone-sensitivity-medium=The icon used to indicate medium microphone sensitivity
microphone-sensitivity-muted=The icon used to indicate that a microphone is muted

[multimedia]
Name=Multimedia
Description=Icons related to playback of media

media-playlist-repeat=The icon for the repeat mode of a media player
media-playlist-repeat-song=The icon for repeating a song in a media player
media-playlist-shuffle=The icon for the shuffle mode of a media player
media-playlist-consecutive=The icon for consecutive mode of a media player
media-skip-backward=The icon for the skip backward action of a media player
media-seek-backward=The icon for the seek backward action of a media player
media-playback-start=The icon for the start playback action of a media player
media-seek-forward=The icon for the seek forward action of a media player
media-skip-forward=The icon for the skip forward action of a media player
media-playback-stop=The icon for the stop action of a media player
media-playback-pause=The icon for the pause action of a media player
media-eject=The icon for the eject action of a media player or file manager
media-record=The icon for the record action of a media application
media-view-subtitles=The icon used to show subtitles in a media player

[network]
Name=Network
Description=Icons related to network status");

network-transmit-receive=The icon used data is being both transmitted and received simultaneously, while the computing device is connected to a network
network-transmit=The icon used when data is being transmitted, while the computing device is connected to a network
network-receive=The icon used when data is being received, while the computing device is connected to a network
network-idle=The icon used when no data is being transmitted or received, while the computing device is connected to a network
network-error=The icon used when an error occurs trying to intialize the network connection of the computing device
network-offline=The icon used when the computing device is disconnected from the network

[weather]
Name=Weather
Description=Icons about weather conditions

weather-clear=The icon used while the weather for a region is “clear skies”
weather-clear-night=The icon used while the weather for a region is “clear skies” during the night
weather-few-clouds=The icon used while the weather for a region is “partly cloudy”
weather-few-clouds-night=The icon used while the weather for a region is “partly cloudy” during the night
weather-fog=The icon used while the weather for a region is “foggy”
weather-overcast=The icon used while the weather for a region is “overcast”
weather-severe-alert=The icon used while a sever weather alert is in effect for a region
weather-showers=The icon used while rain showers are occurring in a region
weather-showers-scattered=The icon used while scattered rain showers are occurring in a region
weather-snow=The icon used while snow showers are occurring in a region
weather-storm=The icon used while storms are occurring in a region
weather-windy=The icon used while the weather is windy

[navigation]
Name=Navigation
Description=Icons for navigation in the user interface of a program

go-first=The icon for the go to the first item in a list
go-previous=The icon for the go to the previous item in a list
go-next=The icon for the go to the next item in a list
go-last=The icon for the go to the last item in a list
go-bottom=The icon for the go to bottom of a list
go-down=The icon for the go down in a list
go-up=The icon for the go up in a list
go-top=The icon for the go to the top of a list
go-home=The icon for the go to home location
go-jump=The icon for the jump to action

[editing]
Name=Editing
Description=Icons related to editing a document
format-indent-less=The icon for the decrease indent formatting action
format-indent-more=The icon for the increase indent formatting action
format-justify-center=The icon for the center justification formatting action
format-justify-fill=The icon for the fill justification formatting action
format-justify-left=The icon for the left justification formatting action
format-justify-right=The icon for the right justification action
format-text-direction-ltr=The icon for the left-to-right text formatting action
format-text-direction-rtl=The icon for the right-to-left formatting action
format-text-bold=The icon for the bold text formatting action
format-text-italic=The icon for the italic text formatting action
format-text-underline=The icon for the underlined text formatting action
format-text-strikethrough=The icon for the strikethrough text formatting action
edit-clear=The icon for the clear action
edit-clear-all=
edit-copy=The icon for the copy action
edit-cut=The icon for the cut action
edit-delete=The icon for the delete action
edit-find-replace=The icon for the find and replace action
edit-paste=The icon for the paste action
edit-redo=The icon for the redo action
edit-select-all=The icon for the select all action
edit-select=
edit-undo=The icon for the undo action
error-correct=
document-properties=The icon for the action to view the properties of a document in an application
document-new=The icon used for the action to create a new document
document-open=The icon used for the action to open a document
document-open-recent=The icon used for the action to open a document that was recently opened
document-save=The icon for the save action. Should be an arrow pointing down and toward a hard disk
document-save-as=The icon for the save as action
document-send=The icon for the send action. Should be an arrow pointing up and away from a hard disk
document-page-setup=The icon for the page setup action of a document editor
document-edit=The icon for the action to edit a document
object-flip-horizontal=The icon for the action to flip an object horizontally
object-flip-vertical=The icon for the action to flip an object vertically
object-rotate-left=The icon for the rotate left action performed on an object
object-rotate-right=The icon for the rotate rigt action performed on an object
insert-image=The icon for the insert image action of an application
insert-link=The icon for the insert link action of an application
insert-object=The icon for the insert object action of an application
insert-text=The icon for the insert text action of an application
accessories-text-editor=The icon used for the desktop's text editing accessory program

[view]
Name=View Controls
Description=Icons for view controls in a user interface

view-list=The icon used for “List“ view mode
view-grid=The icon used for “Grid“ view mode (as opposed to “List“)
view-fullscreen=The icon used for the “Fullscreen” item in the application's “View” menu
view-restore=The icon used by an application for leaving the fullscreen view, and returning to a normal windowed view
zoom-fit-best=The icon used for the “Best Fit” item in the application's “View” menu
zoom-in=The icon used for the “Zoom in” item in the application's “View” menu
zoom-out=The icon used for the “Zoom Out” item in the application's “View” menu
zoom-original=The icon used for the “Original Size” item in the application's “View” menu
view-continuous=The icon used for a continuous view mode
view-paged=The icon used for a paged view mode (as opposed to continuous)
view-dual=The icon used for a side-by-side view of paginated content
view-wrapped=The icon used to indicate a wrap-around to the beginning
view-pin=The icon used for 'pin a view'

[calendar]
Name=Calendar, Tasks and Alarms
Description=Icons related to calendars, tasks and alarms

task-due=The icon used when a task is due soon
task-past-due=The icon used when a task that was due, has been left incomplete
appointment-soon=The icon used when an appointment will occur soon
appointment-missed=The icon used when an appointment was missed
alarm=The icon used for alarms when a task or appointment is due

[communication]
Name=Communication
Description=Icons related email, phone calls, IM and other forms of communication

mail-unread=The icon used for an electronic mail that is unread
mail-read=The icon used for an electronic mail that is read
mail-replied=The icon used for an electronic mail that has been replied to
mail-attachment=The icon used for an electronic mail that contains attachments
mail-mark-important=The icon for the mark as important action of an electronic mail application
mail-send=The icon for the send action of an electronic mail application
mail-send-receive=The icon for the send and receive action of an electronic mail application
call-start=The icon used for initiating or accepting a call
call-stop=The icon used for stopping a current call
call-missed=The icon used to show a missed call
user-available=The icon used when a user on a chat network is available to initiate a conversation with
user-offline=The icon used when a user on a chat network is not available
user-idle=The icon used when a user on a chat network has not been an active participant in any chats on the network, for an extended period of time
user-invisible=The icon used when a user is on a chat network, but is invisible to others
user-busy=The icon used when a user is on a chat network, and has marked himself as busy
user-away=The icon used when a user on a chat network is away from their keyboard and the chat program
user-status-pending=The icon used when the current user status on a chat network is not known

[devices]
Name=Devices and Media
Description=Icons for devices and media

audio-input-microphone=The icon used for the microphone audio input device
camera-web=The fallback icon for web cameras
camera-photo=The icon used for a digital still camera devices
input-keyboard=The icon used for the keyboard input device
printer=The icon used for a printer device
video-display=The icon used for the monitor that video gets displayed to
computer=The icon used for the computing device as a whole
media-optical=The icon used for physical optical media such as CD and DVD
phone=The icon used for phone devices which support connectivity to the PC, such as VoIP, cellular, or possibly landline phones
input-dialpad=The icon used for dialpad input devices
input-touchpad=The icon used for touchpad input devices
scanner=The icon used for a scanner device
audio-card=The icon used for the audio rendering device
input-gaming=The icon used for the gaming input device
input-mouse=The icon used for the mousing input device
multimedia-player=The icon used for generic multimedia playing devices
audio-headphones=The icon used for headphones
audio-headset=The icon used for headsets
display-projector=The icon used for projectors
media-removable=The icon used for generic removable media
printer-network=The icon used for printers which are connected via the network
audio-speakers=The icon used for speakers
camera-video=The fallback icon for video cameras
drive-optical=The icon used for optical media drives such as CD and DVD
drive-removable-media=The icon used for removable media drives
input-tablet=The icon used for graphics tablet input devices
network-wireless=The icon used for wireless network connections
network-wired=The icon used for wired network connections
media-floppy=The icon used for physical floppy disk media
media-flash=The fallback icon used for flash media, such as memory stick and SD

[contenttypes]
Name=Content Types
Description=Icons for different types of data, such as audio or image files

application-certificate=
application-rss+xml=
application-x-appliance=
audio-x-generic=The icon used for generic audio file types
folder=The standard folder icon used to represent directories on local filesystems, mail folders, and other hierarchical groups
text-x-generic=The icon used for generic text file types
video-x-generic=The icon used for generic video file types
x-office-calendar=The icon used for generic calendar file types

[emotes]
Name=Emotes
Description=Icons for emotions that are expressed through text chat applications such as :-) or :-P in IRC or instant messengers

face-angel=The icon used for the 0:-) emote
face-angry=The icon used for the X-( emote
face-cool=The icon used for the B-) emote
face-crying=The icon used for the :'( emote
face-devilish=The icon used for the >:-) emote
face-embarrassed=The icon used for the :-[ emote
face-kiss=The icon used for the :-* emote
face-laugh=The icon used for the :-)) emote
face-monkey=The icon used for the :-(|) emote
face-plain=The icon used for the :-| emote
face-raspberry=The icon used for the :-P emote
face-sad=The icon used for the :-( emote
face-shutmouth=The 'shut mouth' emote
face-sick=The icon used for the :-& emote
face-smile=The icon used for the :-) emote
face-smile-big=The icon used for the :-D emote
face-smirk=The icon used for the :-! emote
face-surprise=The icon used for the :-0 emote
face-tired=The icon used for the |-) emote
face-uncertain=The icon used for the :-/ emote
face-wink=The icon used for the ;-) emote
face-worried=The icon used for the :-S emote
face-yawn=

[general]
Name=General
Description=Generally useful icons that don't fit in a particular category

edit-find=The icon for generic search actions
content-loading=The icon used to indicate that content is loading
open-menu=The icon used for a menu button in the header bar
view-more=The icon used for a  “View More“ action
tab-new=The icon used for a “New Tab“ action
bookmark-new=The icon used for creating a new bookmark
mark-location=The icon used to mark a location on a map
find-location=The icon used for a  “Search location“ action
send-to=The icon used for a  “Send to“ action
object-select=The icon used for generic selection actions
window-close=The icon used for actions that close a view, such as window or tab close button
view-refresh=The icon used for the “Refresh” item in the application's “View” menu
process-stop=The icon used for the “Stop” action in applications with actions that may take a while to process, such as web page loading in a browser
action-unavailable=The icon used to indicate that an action is currently unavailable, such as “Pause“ when no media is playing
document-print=The icon for the print action of an application
printer-printing=The icon used while a print job is successfully being spooled to a printing device
printer-warning=The icon used when a recoverable problem occurs while attempting to printing
printer-error=The icon used when an error occurs while attempting to print
dialog-information=The icon used when a dialog is opened to give information to the user that may be pertinent to the requested action
dialog-question=The icon used when a dialog is opened to ask a simple question of the user
dialog-warning=The icon used when a dialog is opened to warn the user of impending issues with the requested action
dialog-password=The icon used when a dialog requesting the authentication credentials for a user is opened
dialog-error=The icon used when a dialog is opened to explain an error condition to the user
list-add=The icon for the add to list action
list-remove=The icon for the remove from list action
non-starred=The icon used to indicate that an object is not 'starred'
semi-starred=The icon used to indicate that an object has is 'half-starred'
starred=The icon used to indicate that an object is 'starred'
star-new=The used for the “New Star“ action
security-low=The icon used to indicate that the security level of a connection is presumed to be insecure, either by using weak encryption, or by using a certificate that the could not be automatically verified, and which the user has not chosent to trust
security-medium=The icon used to indicate that the security level of a connection is presumed to be secure, using strong encryption, and a certificate that could not be automatically verified, but which the user has chosen to trust
security-high=The icon used to indicate that the security level of a connection is known to be secure, using strong encryption and a valid certificate
user-trash=The icon for the user's “Trash” place in the file system
user-trash-full=The icon for the user's “Trash” in the file system, when there are items in the “Trash” waiting for disposal or recovery
emblem-system=The icon used as an emblem for directories that contain system libraries, settings, and data
avatar-default=The generic avatar icon, which is used to represent a user that doesn't have a personalized avatar
emblem-synchronizing=The icon used as an emblem to indicate that a a synchronizing operation is in process
emblem-shared=The icon used as an emblem for files and directories that are shared to other users
help-browser=The icon used for the desktop's help browsing application

[other]
Name=Other
Description=Icons which have may be too specialized and not of general interest

changes-allow=
changes-prevent=
view-sort-ascending=The icon used for the “Sort Ascending” item in the application's “View” menu, or in a button for changing the sort method for a list
view-sort-descending=The icon used for the “Sort Descending” item in the application's “View” menu, or in a button for changing the sort method for a list
document-revert=The icon for the action of reverting to a previous version of a document
address-book-new=The icon used for the action to create a new address book
application-exit=The icon used for exiting an application. Typically this is seen in the application's menus as File->Quit
appointment-new=The icon used for the action to create a new appointment in a calendaring application
contact-new=The icon used for the action to create a new contact in an address book application
document-print-preview=The icon for the print preview action of an application
folder-new=The icon for creating a new folder
help-about=The icon for the About item in the Help menu
help-contents=The icon for Contents item in the Help menu
help-faq=The icon for the FAQ item in the Help menu
list-remove-all=
mail-forward=The icon for the forward action of an electronic mail application
mail-mark-junk=The icon for the mark as junk action of an electronic mail application
mail-mark-notjunk=The icon for the mark as not junk action of an electronic mail application
mail-mark-read=The icon for the mark as read action of an electronic mail application
mail-mark-unread=The icon for the mark as unread action of an electronic mail application
mail-message-new=The icon for the compose new mail action of an electronic mail application
mail-reply-all=The icon for the reply to all action of an electronic mail application
mail-reply-sender=The icon for the reply to sender action of an electronic mail application
pan-down=
pan-end=
pan-start=
pan-up=
system-lock-screen=The icon used for the “Lock Screen” item in the desktop's panel application
system-log-out=The icon used for the “Log Out” item in the desktop's panel application
system-run=The icon used for the “Run Application...” item in the desktop's panel application
system-search=The icon used for the “Search” item in the desktop's panel application
system-reboot=The icon used for the “Reboot” item in the desktop's panel application
system-shutdown=The icon used for the “Shutdown” item in the desktop's panel application
tools-check-spelling=The icon used for the “Check Spelling” item in the application's “Tools” menu
window-maximize=
window-minimize=
window-restore=
window-new=The icon used for the “New Window” item in the application's “Windows” menu
accessories-calculator=The icon used for the desktop's calculator accessory program
accessories-character-map=The icon used for the desktop's international and extended text character accessory program
accessories-dictionary=The icon used for the desktop's dictionary accessory program
multimedia-volume-control=The icon used for the desktop's hardware volume control application
preferences-desktop-accessibility=The icon used for the desktop's accessibility preferences
preferences-desktop-display=
preferences-desktop-font=The icon used for the desktop's font preferences
preferences-desktop-keyboard=The icon used for the desktop's keyboard preferences
preferences-desktop-keyboard-shortcuts=
preferences-desktop-locale=The icon used for the desktop's locale preferences
preferences-desktop-remote-desktop=
preferences-desktop-multimedia=The icon used for the desktop's multimedia preferences
preferences-desktop-screensaver=The icon used for the desktop's screen saving preferences
preferences-desktop-theme=The icon used for the desktop's theme preferences
preferences-desktop-wallpaper=The icon used for the desktop's wallpaper preferences
preferences-system-privacy=
preferences-system-windows=
system-file-manager=The icon used for the desktop's file management application
system-software-install=The icon used for the desktop's software installer application
system-software-update=The icon used for the desktop's software updating application
system-users=
user-info=
utilities-system-monitor=The icon used for the desktop's system resource monitor application
utilities-terminal=The icon used for the desktop's terminal emulation application.
application-x-addon=
application-x-executable=The icon used for executable file types
font-x-generic=The icon used for generic font file types
image-x-generic=The icon used for generic image file types
package-x-generic=The icon used for generic package file types
text-html=The icon used for HTML text file types
text-x-generic-template=The icon used for generic text templates
text-x-preview=
text-x-script=The icon used for script file types, such as shell scripts
x-office-address-book=The icon used for generic address book file types
x-office-document=The icon used for generic document and letter file types
x-office-document-template=
x-office-presentation=The icon used for generic presentation file types
x-office-presentation-template=
x-office-spreadsheet=The icon used for generic spreadsheet file types
x-office-spreadsheet-template=
x-package-repository=
applications-accessories=The icon for the “Accessories” sub-menu of the Programs menu
applications-development=The icon for the “Programming” sub-menu of the Programs menu
applications-engineering=The icon for the “Engineering” sub-menu of the Programs menu
applications-games=The icon for the “Games” sub-menu of the Programs menu
applications-graphics=The icon for the “Graphics” sub-menu of the Programs menu
applications-internet=The icon for the “Internet” sub-menu of the Programs menu
applications-multimedia=The icon for the “Multimedia” sub-menu of the Programs menu
applications-office=The icon for the “Office” sub-menu of the Programs menu
applications-other=The icon for the “Other” sub-menu of the Programs menu
applications-science=The icon for the “Science” sub-menu of the Programs menu
applications-system=The icon for the “System Tools” sub-menu of the Programs menu
applications-utilities=The icon for the “Utilities” sub-menu of the Programs menu
preferences-desktop=The icon for the “Desktop Preferences” category
preferences-desktop-peripherals=The icon for the “Peripherals” sub-category of the “Desktop Preferences” category
preferences-desktop-personal=The icon for the “Personal” sub-category of the “Desktop Preferences” category
preferences-other=The icon for the “Other” preferences category
preferences-system=The icon for the “System Preferences” category
preferences-system-network=The icon for the “Network” sub-category of the “System Preferences” category
system-help=The icon for the “Help” system category
battery=The icon used for the system battery device
computer-apple-ipad=
colorimeter-colorhug=
drive-harddisk=The icon used for hard disk drives
drive-harddisk-ieee1394=
drive-harddisk-system=
drive-multidisk=
media-optical-bd=
media-optical-cd-audio=
media-optical-dvd=
media-tape=The icon used for generic physical tape media
media-zip=
modem=The icon used for modem devices
multimedia-player-apple-ipod-touch=
network-vpn=
pda=This is the fallback icon for Personal Digial Assistant devices. Primary use of this icon is for PDA devices connected to the PC. Connection medium is not an important aspect of the icon. The metaphor for this fallback icon should be a generic PDA device icon
phone-apple-iphone=
uninterruptible-power-supply=
emblem-default=The icon used as an emblem to specify the default selection of a printer for example
emblem-documents=The icon used as an emblem for the directory where a user's documents are stored
emblem-downloads=The icon used as an emblem for the directory where a user's downloads from the internet are stored
emblem-favorite=The icon used as an emblem for files and directories that the user marks as favorites
emblem-generic=
emblem-important=The icon used as an emblem for files and directories that are marked as important by the user
emblem-mail=The icon used as an emblem to specify the directory where the user's electronic mail is stored
emblem-new=
emblem-ok=
emblem-package=
emblem-photos=The icon used as an emblem to specify the directory where the user stores photographs
emblem-readonly=The icon used as an emblem for files and directories which can not be written to by the user
emblem-symbolic-link=The icon used as an emblem for files and direcotires that are links to other files or directories on the filesystem
emblem-synchronized=The icon used as an emblem for files or directories that are configured to be synchronized to another device
emblem-unreadable=The icon used as an emblem for files and directories that are inaccessible.
emblem-urgent=
emblem-videos=
emblem-web=
folder-documents=
folder-download=The icon representing the location in the file system where downloaded files are stored
folder-music=
folder-pictures=
folder-publicshare=
folder-remote=The icon used for normal directories on a remote filesystem
folder-saved-search=
folder-templates=
folder-videos=
network-server=The icon used for individual host machines under the “Network Servers” place in the file manager
network-workgroup=The icon for the “Network Servers” place in the desktop's file manager, and workgroups within the network
start-here=The icon used by the desktop's main menu for accessing places, applications, and other features
user-bookmarks=The icon for the user's special “Bookmarks” place
user-desktop=The icon for the special “Desktop” directory of the user
user-home=The icon for the special “Home” directory of the user
airplane-mode=
battery-caution-charging=
battery-caution=The icon used when the battery is below 40%
battery-empty-charging=
battery-empty=
battery-full-charged=
battery-full-charging=
battery-full=
battery-good-charging=
battery-good=
battery-low-charging=
battery-low=The icon used when the battery is below 20%
battery-missing=
bluetooth-active=
bluetooth-disabled=
channel-insecure=
channel-secure=
computer-fail=
display-brightness=
keyboard-brightness=
folder-drag-accept=The icon used for a folder while an object is being dragged onto it, that is of a type that the directory can contain
folder-open=The icon used for folders, while their contents are being displayed within the same window. This icon would normally be shown in a tree or list view, next to the main view of a folder's contents
folder-visiting=The icon used for folders, while their contents are being displayed in another window. This icon would typically be used when using multiple windows to navigate the hierarchy, such as in Nautilus's spatial mode
image-loading=The icon used when another image is being loaded, such as thumnails for larger images in the file manager
image-missing=The icon used when another image could not be loaded
mail-signed=The icon used for an electronic mail that contains a signature
mail-signed-verified=The icon used for an electronic mail that contains a signature which has also been verified by the security system
network-cellular-3g=
network-cellular-4g=
network-cellular-edge=
network-cellular-gprs=
network-cellular-umts=
network-cellular-acquiring=
network-cellular-connected=
network-cellular-no-route=
network-cellular-offline=
network-cellular-signal-excellent=
network-cellular-signal-good=
network-cellular-signal-ok=
network-cellular-signal-weak=
network-cellular-signal-none=
network-vpn-acquiring=
network-vpn=
network-wired-acquiring=
network-wired-disconnected=
network-wired-no-route=
network-wired-offline=
network-wireless-acquiring=
network-wireless-connected=
network-wireless-encrypted=
network-wireless-hotspot=
network-wireless-no-route=
network-wireless-offline=
network-wireless-signal-excellent=
network-wireless-signal-good=
network-wireless-signal-ok=
network-wireless-signal-weak=
network-wireless-signal-none=
rotation-allowed=
rotation-locked=
software-update-available=The icon used when an update is available for software installed on the computing device, through the system software update program
software-update-urgent=The icon used when an urgent update is available through the system software update program
sync-error=The icon used when an error occurs while attempting to synchronize data from the computing device, to another device
sync-synchronizing=The icon used while data is successfully synchronizing to another device
touchpad-disabled=
trophy-bronze=
trophy-silver=
trophy-gold=
night-light=
daytime-sunrise=
daytime-sunset=
